...................................................................................................................................................................................................................
.                                                                                                                                                                                                                 .
.                                                                                                                                                                                                                 .
.                                                                                                                                                                                                                 .
.                                                                                                                                                                                                                 .
.                                                                                   ===============                                                    ==========================                                 .
.                                               ==================                                                                                                                                                .
.                                                                                                                                                                                                                 .
.                                                                                                                                                                                                                 .
.                                                                                                                                                                                                                 .
.                       ||||||||||||                                                                                    |||||||||||||||                                                     |||||||||||           .
.                       ||||||||||||                                                                                    |||||||||||||||                                                     |||||||||||           .
.                       ||||||||||||                                                                                    |||||||||||||||                                                     |||||||||||           .
.                       ||||||||||||                                                                                    |||||||||||||||                                                     |||||||||||           .
.                       ||||||||||||                                                                                    |||||||||||||||                                                     |||||||||||           .
%%%%%%%%%%%%%%%%%%%%%%%%%%%%%%%%%%%%%%%%%%%%%%%%%%%%%%%%%%%%%%%%%%%%%%%%%%%%%%%%%%%%%%%%%%%%%%%%%%%%%%%%%%%%%%%%%%%%%%%%%%%%%%%%%%%%%%%%%%%%%%%%%%%%%%%%%%%%%%%%%%%%%%%%%%%%%%%%%%%%%%%%%%%%%%%%%%%%%%%%%%%%%%%%%%%
%%%%%%%%%%%%%%%%%%%%%%%%%%%%%%%%%%%%%%%%%%%%%%%%%%%%%%%%%%%%%%%%%%%%%%%%%%%%%%%%%%%%%%%%%%%%%%%%%%%%%%%%%%%%%%%%%%%%%%%%%%%%%%%%%%%%%%%%%%%%%%%%%%%%%%%%%%%%%%%%%%%%%%%%%%%%%%%%%%%%%%%%%%%%%%%%%%%%%%%%%%%%%%%%%%%